GAME
{
// PDA belongs to Charles Rivera

// Inbox

"MailFrom1"	"差出人: フィル・ライアン"
"MailDate1"	"送信日時: 52年12月20日"
"MailSubject1"	"件名: 迷惑メールだ！"
"MailBody1A"	"ミスター・リベラへ、"
"MailBody1B"	"ここらのみんなが思っていることだろうから代表して言うよ。 迷惑メールをなんとかして下さいませんかねぇ？ 受信トレイのフィルターを更新しろとかなんとか、アンタが一番詳しいんだろうけどさ、でも本当に頼むから何とかしてくれよ！ 先月受け取ったあの大量のゴミ1通ごとに5セントかかるし、しかもこれが一生続くんだぞ。"
"MailBody1C"	"フィル・ライアンより"

"MailFrom2"	"差出人: ミラー博士"
"MailSubject2"	"Fwd: オクスリをどうぞ！！！！"
"MailDate2"	"送信日時: 52年12月12日"
"MailBody2A"	"SynNetで合法な良くキくクスリを手に入れましょう！！"
"MailBody2B"	"ア亻ソ夕三ン23がなんと1パックたったの99$の込み込み価格！！！"
"MailBody2C"	"星間輸送も対応しています。"
"MailBody2D"	"ア亻ソ夕三ン23で丸一日働いても気分爽快、気合十分、気力満点！！ あなたの監督官も使ってるよ--あなたも使うべきじゃない？"

// Sent

"MailFrom3"	"宛先: フィル・ライアン"
"MailDate3"	"送信日時: 52年12月20日"
"MailSubject3"	"件名: Re: 迷惑メールだ！"
"MailBody3A"	"親愛なる方へ、"
"MailBody3B"	"わが社に関心を持ってメールを送っていただきありがとうございます。 頂いたご意見は慎重に調査し、担当者が可能な限り迅速に問題に対処します。 このEメールには返信できません。 できる限り早くこちらから報告をお送りします。"
"MailBody3C"	"SynTek運営部/システム管理者"
"MailBody3D"	"チャールズ・リベラ"
}