GAME
{
// PDA belongs to Brad Campbell

// Inbox

"MailFrom1"	"Da: David Anders"
"MailDate1"	"Data: 12/12/52"
"MailSubject1"	"Soggetto: Tute ambientali"
"MailBody1A"	"Caspita Brad, il caldo sta diventando insopportabile. Abbiamo trovato un altro campo di lava vicino al tunnel 11, quindi è probabile che le cose non migliorino. Che ne è stato di quelle tute ambientali?"
"MailBody1B"	"Dave"

"MailFrom2"	"Da: David Anders"
"MailDate2"	"Data: 12/14/52"
"MailSubject2"	"Soggetto: Daxol"
"MailBody2A"	"Brad,"
"MailBody2B"	"Accidenti. Ho parlato con Pete e Kovac. Ammettono apertamente che le persone hanno iniziato a usare di nuovo Daxol regolarmente. Proprio quando pensavamo che le cose stessero tornando alla normalità. Cosa volete che faccia?"

// Sent

"MailFrom3"	"A: David Anders"
"MailDate3"	"Data: 12/12/52"
"MailSubject3"	"Soggetto: Re: Tute ambientali"
"MailBody3A"	"Ciao Dave,"
"MailBody3B"	"Li ho ordinati molto tempo fa. Non so perché non fossero nell'ultima navetta di rifornimento. Tutto quello che posso fare è lamentarmi, cosa che sto facendo, ma sai quanto può servire. A proposito, ho sentito di nuovo voci su abusi di Daxol. Puoi starci attento?"
"MailBody3C"	"Saluti, Brad"

"MailFrom4"	"A: David Anders"
"MailDate4"	"Data: 12/14/52"
"MailSubject4"	"Soggetto: Re: Daxol"
"MailBody4A"	"David,"
"MailBody4B"	"Grazie. Parlerò con loro. Non voglio segnalarlo. Ho sempre detto che i lavoratori dovrebbero essere pagati all'ora, non per quanto velocemente possono scavare buche in quella dannata roccia. Non possiamo fare molto al riguardo."
}