GAME
{
// PDA belongs to Dr. Lin Da Silva

// Inbox

"MailFrom1"	"От: Д-р. Жак Моро"
"MailDate1"	"Дата: 10.02.42"
"MailSubject1"	"Тема: На: Перевод научного персонала"
"MailBody1A"	"Доктор Да Сильва, мои исследования требуют от меня точности, близкой к хирургической. И с этим, что вполне уместно на самом деле, надлежащая сосредоточенность. «Правильная» лишь в том смысле, что меня не будут постоянно прерывать пустяковыми заботами."
"MailBody1B"	"Хотя я ценю огромную помощь, оказанную до сих пор вашими помощниками, текущие операции, за которые я отвечаю в силу моих полномочий главного учёного этой миссии, будут завершены, если все, наконец, согласятся оставить меня наедине с моей работой."
"MailBody1C"	"Спасибо"

// Sent

"MailFrom3"	"Кому: Д-р. Жак Моро"
"MailDate3"	"Дата: 09.02.42"
"MailSubject3"	"Тема: Перевод научного персонала"
"MailBody3A"	"Др. Моро"
"MailBody3B"	"По вашей просьбе я переключила усилия команды биологов на общие исследования; предметы, полученные в результате нашего последнего открытия, также были переданы в ваши личные лаборатории. Могу ли я, однако, спросить вас о причинах такого решения?"
"MailBody3C"	"Искренне ваша"
"MailBody3D"	"Д-р. Лин Да Сильва"

"MailFrom4"	"Кому: Д-р. Жак Моро"
"MailDate4"	"Дата: 10.02.42"
"MailSubject4"	"Тема: На: На: Перевод научного персонала"
"MailBody4A"	"Др. Моро"
"MailBody4B"	"Конечно, я понимаю. Ставить под сомнение ваши методы не входило в мои намерения. Дополнительные предметы будут отправлены вам к концу недели. Нам Гуманум."
"MailBody4C"	"Искренне ваша"
"MailBody4D"	"Д-р. Лин Да Сильва"
}