GAME
{
// PDA belongs to Brian Howe

// Inbox

"MailFrom1"	"송신자: 헬렌 영"
"MailDate1"	"날짜: 52년 12월 23일"
"MailSubject1"	"주제: 아트리움이 닫혔어!"
"MailBody1A"	"안녕,"
"MailBody1B"	"오늘 아침에 아트리움을 폐쇄해야 했어! 남쪽 동뿐만 아니라 전체 시설을 말이야. 우린 오염이 2 갑판에서 환기 시스템을 통해 퍼지고 있다고 들었고. 보안 인원들이 1 갑판의 북서쪽 전체 구역을 지키고 있어. 그들은 꽤나 불친절해."
"MailBody1C"	"한편, 오늘 아침에 그 멍청이 밍에게 메일을 받았어. 그와 사람들이 실험실에서 여전히 일하고 있는 것 같아, 네가 발견한 알들을 연구하면서. 그의 연구가 동맹의 승인을 받지 않은게 확실해."
"MailBody1D"	"나중에 봐--헬렌"

// Sent

"MailFrom3"	"수신자: 헬렌 영"
"MailDate3"	"날짜: 52년 12월 23일"
"MailSubject3"	"주제: 회신: 아트리움이 닫혔어!"
"MailBody3A"	"헬렌, 여기 아랜 상황이 아주 나빠! 오늘 밤 다른 시신을 찾았어. 이건 부분적으로 먹어치워졌는데. 뭔가가 아래에 있어. 뭔가가. 케인과 십 여명이 나타나, 엘레베이터를 타고 티모르 역으로 내려가며, 우리에게 물러서있으라 했고. 잠깐 후에, 총성을 들었어."
"MailBody3B"	"케인이 돌아왔을 땐, 두 명으로 줄어있었고, 둘 다 심각하게 다쳐있었어. 케인이, 우리 사람들을 광산밖으로 끌어내야한다고 했지만. 그들은 여기저기 흩어져 있기 때문에, 불가능하다고 말했어. 그는 내 말에 으쓱하고는. 지금부터는 내 책임이라고 했어. 그리고 그는 떠났어."
"MailBody3C"	"그래서, 데이브와 톰을 데리고 갈꺼야. 실종된 인부들에대한 마지막 수색을 해보겠어. 난 너가 이걸 동맹 요원인 로라 캘런에게 알렸으면 좋겠어. 그러는 동안, 그녀에게 밍에대해 말해줘. 그녀는 케인과 동등하게 설 수 있는 권한을 가진 유일한 사람이야."
"MailBody3D"	"조심해! 브라이언이"
}