GAME
{
// PDA belongs to Brian Howe

// Inbox

"MailFrom1"	"Da: Laura Callen"
"MailDate1"	"Data: 21/12/52"
"MailSubject1"	"Oggetto: Flusso di informazioni"
"MailBody1A"	"Sig. Howe,"
"MailBody1B"	"Perché non mi hai informata delle uova che tu e il tuo equipaggio avete trovato nella miniera la scorsa settimana. A meno che tu non possa fornire una valida giustificazione per questa omissione, dovrò presentare un rapporto."
"MailBody1C"	"L. Callen"

"MailFrom2"	"Da: Laura Callen"
"MailDate2"	"Data: 21/12/52"
"MailSubject2"	"Oggetto: Re: Re: Flusso di informazioni"
"MailBody2A"	"Sig. Howe,"
"MailBody2B"	"Ho controllato i miei registri ma non vedo il tuo promemoria, è preoccupante. Ho parlato con l'amministratore di sistema, nella speranza di trovare una sorta di spiegazione. Prenderò il prossimo treno per la stazione di Timor. Arriverò alle 0845. Potresti venirmi a prendere?"
"MailBody2C"	"L. Callen"

// Sent

"MailFrom3"	"A: Laura Callen"
"MailDate3"	"Data: 21/12/52"
"MailSubject3"	"Oggetto: Re: Flusso di informazioni"
"MailBody3A"	"Cara Sig.rina Callen,"
"MailBody3B"	"Ho seguito la procedura. Ti ho inviato un memo dettagliato 6 giorni fa. Ti ho anche inviato per e-mail i problemi di sicurezza che abbiamo riscontrato di recente alla Stazione di Timor. Due lavoratori sono scomparsi lunedì e oggi abbiamo avuto un incidente mortale."
"MailBody3C"	"I miei uomini sono sfiniti dal lavoro a doppio turno. Il caldo è opprimente e stanno iniziando ad avere allucinazioni dalla fatica... parlano di rumori inspiegabili e cose simili. Vorrei che parlassi con la SynTek e riuscissi a far migliorare le cose qui al più presto."
"MailBody3D"	"B. Howe"
}