GAME
{
// PDA belongs to Jan Anath

// Inbox

"MailFrom1"	"De: Windom King"
"MailDate1"	"Data: 29/02/53"
"MailSubject1"	"Assunto: Segurança"
"MailBody1A"	"Jan, estamos recebendo algo nos sensores, não tenho certeza se é importante ou não, mas é incomum."
"MailBody1B"	"Pode ser um asteroide ou uma cápsula caída."
"MailBody1C"	""
"MailBody1D"	"Chefe de Segurança W. King"

// Sent

"MailFrom3"	"Para: Windom King"
"MailDate3"	"Data: 29/02/53"
"MailSubject3"	"Assunto: Re: Segurança"
"MailBody3A"	"Estou suspeitando de uma possível ameaça à segurança. Podemos ter que enfrentar a possibilidade de um espião industrial nas instalações."
"MailBody3B"	"Mantenha os olhos abertos e peça à sua equipe que relate qualquer coisa para mim."
"MailBody3C"	"A propósito, NÃO me chame de Jan. Administrador principal Anath serve muito bem."
"MailBody3D"	"Administrador Principal J. Anath"
}