GAME
{
// PDA belongs to Hullen

// Inbox

"MailFrom1"	"De: Shaun Ming"
"MailDate1"	"Data: 22/12/52"
"MailSubject1"	"Assunto: Remessa médica"
"MailBody1A"	"Minhas desculpas, Hullen."
"MailBody1B"	"Nossa primeira tentativa de contrabandear um espécime para você foi um fracasso. Callendescobriu o carregamento congelado #4903877."
"MailBody1C"	"No entanto, conseguimos colocar vários espécimes congelados em uma segunda remessa de suprimentos médicos usados."
"MailBody1D"	"A menos que isto seja descoberto, estará com você no CP7 dentro de alguns dias. Ming"

"MailFrom2"	"De: Jenny Coulson"
"MailDate2"	"Data: 24/12/52"
"MailSubject2"	"Assunto: Re: Jantar"
"MailBody2A"	"Oi Hullen,"
"MailBody2B"	"Eu gostaría sim. Eu estou presa nas minas do Jericho até quinta-feira, mas talvez na sexta-feira dia 28?"
"MailBody2C"	"Na verdade, sou alérgica a vegetação de Xenon, alvez possamos sair para beber em vez disso, e então talvez mais tarde..."
"MailBody2D"	"Jenny ;) xxxxx"

// Sent

"MailFrom3"	"Para: Shaun Ming"
"MailDate3"	"Data: 26/12/52"
"MailSubject3"	"Assunto: Re: Remessa médica"
"MailBody3A"	"Ming, a remessa foi recebida."
"MailBody3B"	"Enquanto digito os espécimes estão sendo descongelados dentro do CP7."
"MailBody3C"	"Talvez possamos lançar alguma luz sobre a evolução dessas criaturas. Esse prêmio Nobel já está nas nossas mãos."
"MailBody3D"	"Hullen"

"MailFrom4"	"Para: Jenny Coulson"
"MailDate4"	"Data: 24/12/52"
"MailSubject4"	"Assunto: Jantar?"
"MailBody4A"	"Oi Jenny"
"MailBody4B"	"Eu sei que não nos conhecemos muito bem, mas eu queria saber se você gostaria de sair para jantar comigo?"
"MailBody4C"	"Conheço um lugarzinho simpático que serve comida de Xenon IX, talvez na quarta-feira?"
"MailBody4D"	"Hullen XXXX"
}