GAME
{
	//inbox

"MailFrom1" 	"송신자: 밍"
"MailDate1" 	"날짜: 52년 12월 27일"
"MailSubject1" 	"그것들 태워버려!"
"MailBody1A" 	"그것들을 당신에게 보낸건 실수였어요!  미안해요!"
"MailBody1B" 	"당신의 모든 표본들을 죽여야해요, 당장요!"
"MailBody1C" 	"티모르 역에 있는 벽감에 숨어있는데, 들려와요.  그것들이 나한테 오고있어요!"
"MailBody1D" 	"당신이 할 수 있을 때 그것들을 죽이거나 도망치세요"

"MailFrom2" 	"송신자: 마틴 제리코"
"MailDate2" 	"날짜: 52년 12월 27일"
"MailSubject2" 	"회신: 고기 해동"
"MailBody2A" 	"헬렌, 이 후레자식아!"
// 원문 Hullen 인데 아마 헬렌을 지칭하는 것으로 보임.
"MailBody2B" 	"네가 보낸 건 죽지 않았어!  우리는 그것을 용암 가까이에 가져갔는데 살아났어."
"MailBody2C" 	"그것은 호득손과 제니를 죽였어.  내 말 들려, 당신이 제니를 죽였어!"
"MailBody2D" 	"그것은 날 물었고, 내 안에 뭔가 움직이는게 느껴져... 자라고있어... 당신을 증오해."

	//sent mail

"MailFrom3" 	"수신자: 마틴 제리코"
"MailDate3" 	"날짜: 52년 12월 26일"
"MailSubject3" 	"고기 해동"
"MailBody3A" 	"안녕하세요 마틴,"
"MailBody3B" 	"베레온 XII에서 표본을 몇 개 받았는데, 어떻게 받았는진 묻지 마세요.  표본 중 하나가 운송 중에 죽은 것 같아요."
"MailBody3C" 	"여기선 높은 사람들 모르게 소각장을 사용할 수 없어서, 용암 구덩이 중 하나를 이용해 처분하기 위해 당신 광산으로 보낼게요."
"MailBody3D" 	"헬렌이."
} 