GAME
{
// PDA belongs to Dr. Tom Hinler

// Inbox

"MailFrom1"	"Da: Tom Hinler"
"MailDate1"	"Data: 05/26/60."
"MailSubject1"	"Soggetto: Soggetto 58."
"MailBody1A"	"Giovedì 21 Maggio:"
"MailBody1B"	"Oggi abbiamo implementato con successo un DNA ricombinante sul paziente. Questo DNA proveniva dall'Alieno catturato alcuni giorni fa da una pattuglia. Il paziente sembra essere in buona salute."
"MailBody1C"	"Sabato 23 Maggio:"
"MailBody1D"	"Il paziente parla di mal di testa, nausea e vertigini costanti. Le sue condizioni si stanno deteriorando di giorno in giorno. Forse l'impianto non è riuscito... di nuovo."
"MailBody1E"	"Lunedì 25 Maggio:"
"MailBody1F"	"Abbiamo un vero problema. Il paziente si sta comportando in modo molto strano. Ha attacchi di follia più spesso ed è diventato sempre più violento nei confronti dei medici che si occupano del suo caso. Dobbiamo prendere una decisione."
"MailBody1G"	"Se continua così, finirà per ferire qualcuno, o peggio ..."
"MailBody1H"	"Martedi 26 Maggio:"
"MailBody1I"	"Il paziente è fuggito. Ha ferito due medici. Molti soldati hanno iniziato a cercarlo. Lo hanno trovato nel pomeriggio, con il taglio in ozio e il corpo imbrattato di sangue. Abbiamo portato nella stanza medica e ucciso per intraprendere ulteriori studi. Dovevamo, altrimenti sarebbe degenerato."
"MailBody1J"	""
"MailBody1K"	"= Soggetto 58: Fallito. ="
"MailBody1L"	""
"MailBody1M"	"Dr. Tom Hinler"
}