GAME
{
// PDA belongs to Windows

// Inbox

"MailFrom1"	"De: Childs"
"MailDate1"	"Data: 02/02/54"
"MailSubject1"	"Assunto: Re: Os Canis"
"MailBody1A"	"Cara, Foi bizarro aquilo que rolou mais cedo."
"MailBody1B"	"Quando o Bennings correu até mim, Eu pensei que ele e o Mac"
"MailBody1C"	"tinham ficado loucos. Talves o Mac já esteja?"
"MailBody1D"	"E quem teria imaginado que o lança-chamas seria tão útil?"

"MailFrom2"	"De: Childs"
"MailDate2"	"Data: 02/02/54"
"MailSubject2"	"Assunto: Re:Re: Os Canis"
"MailBody2A"	"Não que eu esteja reclamando, isso definitivamente salvou nosso rabo mas não parece um tanto irresponsável deixar uma arma"
"MailBody2B"	"altamente volátil e extremamente perigosa nas mãos de um bando de pesquisadores com pouco ou nenhum contato externo"
"MailBody2C"	"por tantos meses?"
"MailBody2D"	"Quero dizer, basta um de nós ficar um pouco maluco e estamos todos fritos."

// Sent

"MailFrom3"	"To: Windows"
"MailDate3"	"Date: 02/02/54"
"MailSubject3"	"Assunto: Re: Os Canis"
"MailBody3A"	"sso levanta a questão, somos pesquisadores do Ártico, não soldados, o que diabos estamos fazendo com um lança-chamas?"
"MailBody3A"	"A que possível propósito isso nos serve? Por que isso está aqui?"
"MailBody3C"	"Falando nissoique de olho no Dr. Blair, ele parecia um pouco nervoso desde o incidente do canil."
}