GAME
{
// PDA belongs to Security Officer Barney

// Inbox

"MailFrom1"	"송신자: 빌 하우즈"
"MailDate1"	"날짜: 52년 10월 4일"
"MailSubject1"	"주제: 화염방사기 리필됨"
"MailBody1A"	"안녕 바니"
"MailBody1B"	"요청한대로 네 화염방사기 다시 채워놨어. 왜 사무실에 그걸 보관하는지 모르겠네..."
"MailBody1C"	"이미 신텍에서 제공한 표준 보안 장난감을 가지고 있잖아."
"MailBody1D"	"나중에, 빌"

// Sent

"MailFrom3"	"수신자: 빌 하우즈"
"MailDate3"	"날짜: 52년 10월 4일"
"MailSubject3"	"주제: 회신: 화염방사기 리필됨"
"MailBody3A"	"안녕 거기 빌"
"MailBody3B"	"헤헤, 리필 고마워. 경험 상 주변에 여분의 화력을 가지고 있어야 한다는 걸 배웠거든."
"MailBody3C"	"그 아이는 날 군단과의 몇 만남에서 구해줬어. 언제 다시 필요할지 몰라."
"MailBody3D"	"안전하게 있어, 바니"

"MailFrom4"	"수신자: 월터 잭슨"
"MailDate4"	"날짜: 52년 10월 6일"
"MailSubject4"	"주제: 이상한 움직임"
"MailBody4A"	"보고:"
"MailBody4B"	"레이더 감지기에서 몇 가지 이상 징후를 다시 발견했습니다."
"MailBody4C"	"이번에는 그들이 더 오랜 시간동안 일어나 있었고 이틀 전과 같은 한 표적이 아닌 여러 표적이 있었습니다."
"MailBody4D"	"그리고 다시, 지난 번처럼 갑자기 사라졌습니다. 이것을 확실히 하기 위해 순찰대를 보내 확인하도록 했습니다."
}