GAME
{
// PDA belongs to Walter Jackson

// Inbox

"MailFrom1"	"От: Служба безопасности «СинТек»"
"MailDate1"	"Дата: 07.10.52"
"MailSubject1"	"Тема: ВАЖНО: НА НАС НАПАЛИ"
"MailBody1A"	"ВАЖНОЕ СООБЩЕНИЕ --- ДЛЯ ВСЕГО ПЕРСОНАЛА"
"MailBody1B"	"В настоящее время мы подверглись нападению. Рой уже прорвался через вход и рванулся вперёд."
"MailBody1C"	"Весь персонал должен следовать протоколу эвакуации комплекса прямо сейчас."
"MailBody1D"	"Сохраняйте спокойствие. -Служба безопасности СинТэк"

// Sent

"MailFrom3"	"Кому: Уолтер Джексон"
"MailDate3"	"Дата: 07.10.52"
"MailSubject3"	"Тема: Электрогенераторы"
"MailBody3A"	"Я запер дверь, ведущую к электрогенераторам, так что с электричеством у нас должно быть в порядке. По крайней мере, мы можем эвакуироваться с включённым светом и питанием."
"MailBody3B"	"Рой не должен пробить эту дверь, так как она сильно армирована металлом. Они не смогут пробраться к генераторам, пока не найдут какой-нибудь другой способ проникнуть туда."
"MailBody3C"	"Ага, хотелось бы мне на это посмотреть..."
"MailBody3D"	"-Главный Инженер реактора"
}