GAME
{
// PDA belongs to Security Officer Barney

// Inbox

"MailFrom1"	"Da: Bill Howze"
"MailDate1"	"Data: 10/04/52"
"MailSubject1"	"Soggetto: Il lanciafiamme è di nuovo pieno"
"MailBody1A"	"Ehi Barney"
"MailBody1B"	"Ho ricaricato il tuo lanciafiamme come da lei richiesto. Non so perché tieni quella cosa nel tuo ufficio..."
"MailBody1C"	"Hai i tuoi giocattoli di sicurezza standard già forniti da SynTek."
"MailBody1D"	"A dopo, Bill"

// Sent

"MailFrom3"	"A: Bill Howze"
"MailDate3"	"Data: 10/04/52"
"MailSubject3"	"Soggetto: Re: Il lanciafiamme è di nuovo pieno"
"MailBody3A"	"Ehi Bill"
"MailBody3B"	"Hehe, grazie per averlo riempito. Ho imparato per esperienza che devi avere un po' di potenza di fuoco in più intorno."
"MailBody3C"	"Quella bambina mi ha salvato da non pochi incontri con lo sciame. Non so mai quando potrei averne bisogno di nuovo."
"MailBody3D"	"Stai al sicuro, Barney"

"MailFrom4"	"A: Walter Jackson"
"MailDate4"	"Data: 10/06/52"
"MailSubject4"	"Soggetto: Strani segnali"
"MailBody4A"	"RAPPORTO:"
"MailBody4B"	"Abbiamo notato di nuovo alcune anomalie sullo scanner radar."
"MailBody4C"	"Questa volta è durato più a lungo e c'erano più bersagli invece di uno come due giorni fa."
"MailBody4D"	"E ancora, proprio come l'ultima volta, sono scomparsi all'improvviso. Ho inviato una pattuglia per verificarlo, per essere sicuro."
}