GAME
{
// PDA belongs to Overseer Ross

// Inbox

"MailFrom1"	"De: Jimmy Carter"
"MailDate1"	"Data: 02/02/54"
"MailSubject1"	"Assunto: Redução de Pressão do Reator"
"MailBody1A"	"Ei Ross,"
"MailBody1B"	"Apenas relatando alguns ruídos estranhos na seção 6,"
"MailBody1C"	"e mais tubos quebrados, MUITOS mais tubos, A pressão tá reduzida em 15% no Reator 1."
"MailBody1D"	"Gostaria de uma ajuda, falo com você depois."

"MailFrom2"	"De: Jimmy Carter"
"MailDate2"	"Data: 02/02/54"
"MailSubject2"	"Assunto: John?"
"MailBody2A"	"Ross, Já se passaram quase 8 horas, quando você planeja enviar John aqui embaixo?"

// Sent

"MailFrom3"	"Para: Supervisor Ross"
"MailDate3"	"Date: 02/02/54"
"MailSubject3"	"Assunto: Re: Redução de Pressão do Reator"
"MailBody3A"	"Jimmy,"
"MailBody3B"	"Desculpe Jimmy, estou de mãos atadas, a maioria das instalações estão tentando limpar O acidente na Baía 6."
"MailBody3C"	"No entanto, vou enviar John também, kcontinue verificando o reator, se cair abaixo de 25%, a energia das colônias vai junto"

"MailFrom4"	"Para: Supervisor Ross"
"MailDate4"	"Data: 02/02/54"
"MailSubject4"	"Assunto: Re: John"
"MailBody4A"	"Jimmy,"
"MailBody4B"	"Eu enviei o John ai embaixo logo depois de enviar o e-mail, Leva apenas 20 minutos para chegar até você no máximo"
"MailBody4C"	"Vou falar com os outros amigos dele, ver se eles sabem onde ele está"
"MailBody4D"	"Eu também vou informar a segurança para cuidar dele, há um monte de gente desaparecendo ultimamente"
}