GAME
{
// PDA belongs to Windows
// inbox

"MailFrom1"	"From: Childs"
"MailDate1"	"Date: 02/02/54"
"MailSubject1"	"Subject: Re: The Kennels"
"MailBody1A"	"Man, that was some weird shit that went down earlier."
"MailBody1B"	"When Bennings ran up to me, I thought that he and Mac"
"MailBody1C"	"had gone crazy. Maybe Mac already has?"
"MailBody1D"	"And who would have thought that the flamethrower would actually come in handy?"

"MailFrom2"	"From: Childs"
"MailDate2"	"Date: 02/02/54"
"MailSubject2"	"Subject: Re:Re: The Kennels"
"MailBody2A"	"Not that i'm complaining, it definately saved our asses but doesn't it seem a little irresponsible leaving a highly"
"MailBody2B"	"volatile and downright dangerous weapon in the hands of a bunch of researchers with little to no outside contact"
"MailBody2C"	"for months on end?"
"MailBody2D"	"i mean all it takes is one of us to go a little nutty and we're all toast."

// sent mail
"MailFrom3"	"To: Windows"
"MailDate3"	"Date: 02/02/54"
"MailSubject3"	"Subject: Re: The Kennels"
"MailBody3A"	"It begs the question, we're artic researchers not soldiers, what the hell are we doing with a flamethrower?"
"MailBody3A"	"what possible purpose does it serve us? why is it here?"
"MailBody3C"	"on that note keep an eye on Dr.Blair, he's seemed a bit on edge since the kennel incident."
}
