GAME
{
// PDA belongs to Brad Campbell

// Inbox

"MailFrom1"	"송신자: 로라 캘런"
"MailDate1"	"날짜: 52년 12월 18일"
"MailSubject1"	"주제: 회신: 화물 배송"
"MailBody1A"	"안녕 브래드,"
"MailBody1B"	"이거 이상하네. 운송 로그를 검색해봤는데 '4903877 운송' 아래로 기록된 것이 없어."
"MailBody1C"	"내가 메일을 추적할 때까지 화물을 보관해두는 게 좋을 거야. 그건 주 단지 내의 어딘가에서 보내졌어. 누가 네게 그 주문을 전달했는지 알아내는 것은 그리 어렵지 않을 거야."
"MailBody1D"	"나중에 얘기하자. 몸조심 해."

"MailFrom2"	"송신자: 로라 캘런"
"MailDate2"	"날짜: 52년 12월 18일"
"MailSubject2"	"주제: 회신:회신: 화물 배송"
"MailBody2A"	"브래드, 케인이 발송자인 것 같아. 그에게 그것에 대해 물어봤는데 모든 것을 부인했어. 그는 누구든지 그 컴퓨터를 사용할 수 있다고 말했는데, 충분히 사실이긴 하지만, 내가 보기에 그는 확실해보이지 않았어."
"MailBody2B"	"저들이 화물칸을 떠나기 전에 저 컨테이너들을 검사해줬으면 해."

// Sent

"MailFrom3"	"수신자: 로라 캘런"
"MailDate3"	"날짜: 52년 12월 18일"
"MailSubject3"	"주제: 회신: 알들"
"MailBody3A"	"로라,"
"MailBody3B"	"이 근처 상황이 이상해지고 있어. 네 메일을 본 후 난 우리가 알들을 놓아둔 곳으로 다시 향했는데. 껍질이 부서져 텅 비어 있었어."
"MailBody3C"	"우리는 2인 1조로 17 전초기지를 수색해서 이상 징후가 있는지 알아보기로 했어. 추가 인력을 투입해주면 고맙겠어."
"MailBody3D"	"뭔가 수상한 일이 벌어지고 있다고 생각해도 될 것 같아. 지구로 살아있는 화물을 배송하는 것은 성간 동맹 제한 #77-C에 의거하고 있어. 그 누구도 실수로 그걸 했을 순 없어."
}