GAME
{
// PDA belongs to Juan Rosales

// Inbox

"MailFrom1"	"От: Винсент Бейкер"
"MailDate1"	"Дата: 18.12.52"
"MailSubject1"	"Тема: Работа без удовольствия"
"MailBody1A"	"Эй, Джунито, похоже, что Кэмпбелл хочет, чтобы мы остались на сверхурочное время. Он тоже нашел вас в Секторе 12-18 ?"

"MailFrom2"	"От: Винсент Бейкер"
"MailDate2"	"Дата: 18.12.52"
"MailSubject2"	"Тема: На: На: Работа без удовольствия."
"MailBody2A"	"Хуан,"
"MailBody2B"	"Aххaх! Вы с Стивом? Это, конечно, лучше, чем накуриться. Ну что ж. Проклятая метель всё равно приближается."

// Sent

"MailFrom3"	"Кому: Винсент Бейкер"
"MailDate3"	"Дата: 18.12./52"
"MailSubject3"	"Тема: На: Работа без удовольствия."
"MailBody3A"	"Винц,"
"MailBody3B"	"Нет, он хочет, чтобы я и Стив искали 30-35. Хотите обмен?"
}